C 100,100,214
F 135,197,214

NO ./asset/textures/wall1.xpm
SO ./asset/textures/wall2.xpm
WE ./asset/textures/wall3.xpm
EA ./asset/textures/wall4.xpm

11111111111111111111111111111111
10000000001100000000000000000001
10110000011100000000000000000001
100100000000000000E0000000000001
1011000001110000000000000000001
100000000011000001110111111111
1111011111111101110000000000001
11110111  100011101010010001111
11000001  10101110000000000001
10000000110000001100000010001
10000000000000001101010010001
 100000111010101111101111000111
  1101111110101  101111010001
   111111111111  111111111111
