F 100,100,214
C 135,197,214

EA ./asset/textures/wall4.xpm
NO ./asset/textures/wall1.xpm
SO ./asset/textures/wall2.xpm
WE ./asset/textures/wall3.xpm

1111111111111111111111111
1000000000110000000000001
1011000001110000000000001
100100000000000000W000001
1011000001110000000000001
10000000001100000111011111111
11110111111111011100000000001
11110111  100011101010010001
11000001  101011100000000001
10000000110000001100000010001
10000000000000001101010010001
 100000111010101111101111000111
  1101111110101  101111010001
   111111111111  111111111111
